23 22

1

10

1 5

11 9 0

4
11 11 0
12 11 0
10 11 0
11 12 0

4
2 1 0
20 1 0
2 20 0
20 20 0

11 1 0
11 21 0

0 2 2 2 2 2 2 2 2 2 2 2 2 2 2 2 2 2 2 2 2 2 0
0 2 1 1 1 1 1 1 1 1 1 2 1 1 1 1 1 1 1 1 1 2 0
0 2 1 2 2 2 1 2 2 2 1 2 1 2 2 2 1 2 2 2 1 2 0
0 2 1 2 2 2 1 2 2 2 1 2 1 2 2 2 1 2 2 2 1 2 0
0 2 1 1 1 1 1 1 1 1 1 1 1 1 1 1 1 1 1 1 1 2 0
0 2 1 2 2 2 1 2 1 2 2 2 2 2 1 2 1 2 2 2 1 2 0
0 2 1 1 1 1 1 2 1 1 1 2 1 1 1 2 1 1 1 1 1 2 0
0 2 2 2 2 2 1 2 2 2 1 2 1 2 2 2 1 2 2 2 2 2 0
0 0 0 0 0 2 1 2 1 1 1 1 1 1 1 2 1 2 0 0 0 0 0
0 2 2 2 2 2 1 2 1 2 2 1 2 2 1 2 1 2 2 2 2 2 0
0 1 1 1 1 1 1 1 1 2 1 1 1 2 1 1 1 1 1 1 1 1 0
0 2 2 2 2 2 1 2 1 2 2 2 2 2 1 2 1 2 2 2 2 2 0
0 0 0 0 0 2 1 2 1 1 1 1 1 1 1 2 1 2 0 0 0 0 0
0 2 2 2 2 2 1 2 1 2 2 2 2 2 1 2 1 2 2 2 2 2 0
0 2 1 1 1 1 1 1 1 1 1 2 1 1 1 1 1 1 1 1 1 2 0
0 2 1 2 2 2 1 2 2 2 1 2 1 2 2 2 1 2 2 2 1 2 0
0 2 1 1 1 2 1 1 1 1 1 1 1 1 1 1 1 2 1 1 1 2 0
0 2 2 2 1 2 1 2 1 2 2 2 2 2 1 2 1 2 1 2 2 2 0
0 2 1 1 1 1 1 2 1 1 1 2 1 1 1 2 1 1 1 1 1 2 0
0 2 1 2 2 2 2 2 2 2 1 2 1 2 2 2 2 2 2 2 1 2 0
0 2 1 1 1 1 1 1 1 1 1 1 1 1 1 1 1 1 1 1 1 2 0
0 2 2 2 2 2 2 2 2 2 2 2 2 2 2 2 2 2 2 2 2 2 0

