{
  "scale": 10,
  "numGhosts": 2,
  "teleports": [
    [
      { "x": 0, "y": 6 },
      { "x": 14, "y": 6 }
    ]
  ],
  "map": [
    [0, 2, 2, 2, 2, 2, 2, 2, 2, 2, 2, 2, 2, 2, 0],
    [0, 2, 5, 1, 1, 1, 1, 1, 1, 1, 1, 1, 1, 2, 0],
    [0, 2, 1, 1, 1, 1, 1, 1, 1, 1, 1, 1, 1, 2, 0],
    [0, 2, 1, 1, 1, 1, 1, 1, 6, 1, 1, 1, 1, 2, 0],
    [0, 2, 1, 2, 1, 2, 1, 2, 1, 2, 1, 2, 1, 2, 0],
    [0, 2, 1, 1, 1, 1, 1, 1, 1, 1, 1, 1, 1, 2, 0],
    [4, 1, 1, 1, 1, 1, 1, 1, 1, 1, 1, 1, 1, 1, 4],
    [0, 2, 1, 1, 1, 1, 1, 2, 3, 3, 3, 2, 1, 2, 0],
    [0, 2, 1, 2, 1, 2, 1, 2, 1, 2, 1, 2, 1, 2, 0],
    [0, 2, 1, 1, 1, 1, 1, 1, 1, 1, 1, 5, 1, 2, 0],
    [0, 2, 1, 2, 1, 2, 1, 2, 1, 2, 1, 2, 1, 2, 0],
    [0, 2, 1, 1, 1, 1, 1, 1, 1, 1, 1, 1, 1, 2, 0],
    [0, 2, 2, 2, 2, 2, 2, 2, 2, 2, 2, 2, 2, 2, 0]
  ]
}
